440 210
99 99
n n n n
8
-5 -7 448 224 0 0 0 255 255
-5 134 332 81 1 0 0 255 200
321 135 19 81 1 1 0 255 200
339 176 98 40 0 2 0 190 200
335 201 105 15 1 0 0 255 200
423 18 19 194 1 0 0 255 200
249 73 42 108 1 1 0 255 200
-6 14 18 185 1 0 0 255 200
0
