430 210
12 54
15 11 13 12
172
-10 -12 449 232 0 0 255 204 204
225 149 159 12 0 0 0 153 51
230 161 151 34 0 2 0 153 51
-7 74 65 143 1 3 51 255 0
52 156 103 61 1 1 51 255 0
152 164 104 55 1 3 51 255 0
252 167 11 11 1 3 51 255 0
259 170 13 10 1 3 51 255 0
269 175 13 9 1 3 51 255 0
251 173 16 44 1 3 51 255 0
265 177 18 40 1 3 51 255 0
276 185 62 30 1 3 51 255 0
332 177 37 36 1 3 51 255 0
327 179 32 24 1 3 51 255 0
323 181 30 15 1 3 51 255 0
280 180 6 17 1 3 51 255 0
338 174 51 29 1 3 51 255 0
343 170 94 45 1 3 51 255 0
350 163 90 44 1 3 51 255 0
371 147 71 55 1 3 51 255 0
363 155 63 30 1 3 51 255 0
385 140 44 28 1 3 51 255 0
403 130 37 31 1 3 51 255 0
150 159 33 14 1 1 51 255 0
53 80 12 111 1 3 51 255 0
61 86 12 103 1 3 51 255 0
70 89 6 90 1 3 51 255 0
73 98 28 84 1 3 51 255 0
72 91 19 11 1 3 51 255 0
97 107 8 71 1 3 51 255 0
100 114 36 66 1 3 51 255 0
133 115 20 56 1 3 51 255 0
149 116 35 59 1 3 51 255 0
179 121 21 64 1 3 51 255 0
189 133 22 38 1 3 51 255 0
197 124 9 16 1 3 51 255 0
207 139 10 40 1 3 51 255 0
213 143 9 33 1 3 51 255 0
220 147 11 25 1 3 51 255 0
228 149 7 28 1 3 51 255 0
232 152 6 24 1 3 51 255 0
235 157 12 10 1 3 51 255 0
101 109 20 11 1 3 51 255 0
310 181 6 6 2 0 0 204 0
291 180 6 6 2 0 0 204 0
352 159 5 6 2 0 0 204 0
249 161 5 4 2 0 0 204 0
159 111 7 6 2 0 0 204 0
34 69 6 6 2 0 0 204 0
409 126 6 5 2 0 0 204 0
366 13 31 32 0 0 51 255 255
368 11 27 10 0 0 51 255 255
394 14 5 30 0 0 51 255 255
367 43 27 4 0 0 51 255 255
364 16 11 29 0 0 51 255 255
362 20 15 21 0 0 51 255 255
371 9 23 13 0 0 51 255 255
360 23 12 15 0 0 51 255 255
397 17 4 23 0 0 51 255 255
369 43 22 6 0 0 51 255 255
372 48 16 2 0 0 51 255 255
374 7 17 7 0 0 51 255 255
367 25 5 5 0 1 0 204 204
375 32 9 8 0 1 0 204 204
375 26 4 3 0 1 0 204 204
370 31 3 3 0 1 0 204 204
377 31 5 4 0 1 0 204 204
382 34 3 3 0 1 0 204 204
376 38 7 3 0 1 0 204 204
373 33 9 6 0 1 0 204 204
370 12 5 4 0 1 0 204 204
389 25 5 3 0 1 0 204 204
389 37 4 4 0 1 0 204 204
363 32 3 2 0 1 255 255 255
389 11 2 2 0 1 255 255 255
383 41 1 1 0 1 255 255 255
373 21 3 1 0 1 255 255 255
370 39 1 2 0 1 255 255 255
394 20 3 2 0 1 255 255 255
361 13 4 3 0 0 204 204 204
355 13 3 3 0 0 204 204 204
359 18 5 4 0 0 204 204 204
367 20 4 3 0 0 204 204 204
366 22 4 4 0 0 204 204 204
373 22 3 5 0 0 204 204 204
369 27 2 6 0 0 204 204 204
378 26 5 4 0 0 204 204 204
373 27 1 3 0 0 204 204 204
377 31 3 2 0 0 204 204 204
361 23 3 3 0 0 204 204 204
352 16 4 3 0 0 204 204 204
385 29 4 4 0 0 204 204 204
382 32 2 4 0 0 204 204 204
391 31 2 3 0 0 204 204 204
387 35 4 2 0 0 204 204 204
394 32 2 3 0 0 204 204 204
393 37 5 3 0 0 204 204 204
400 41 4 4 0 0 204 204 204
401 35 4 3 0 0 204 204 204
407 39 3 3 0 0 204 204 204
398 30 4 3 0 0 220 220 230
384 35 1 3 0 0 220 220 230
354 19 4 3 0 0 220 220 230
380 33 2 1 0 0 220 220 230
382 26 2 2 0 0 220 220 230
384 36 4 3 0 0 220 220 230
406 41 4 2 0 0 220 220 230
54 76 5 7 1 3 51 255 0
56 77 7 7 1 3 51 255 0
62 80 6 11 1 3 51 255 0
66 82 3 6 1 3 51 255 0
80 89 5 8 1 3 51 255 0
88 92 5 6 1 3 51 255 0
74 89 7 7 1 3 51 255 0
75 88 6 6 1 3 51 255 0
91 93 4 9 1 3 51 255 0
92 95 4 6 1 3 51 255 0
94 95 5 5 1 3 51 255 0
98 100 5 12 1 3 51 255 0
100 103 5 11 1 3 51 255 0
102 103 5 10 1 3 51 255 0
104 104 8 10 1 3 51 255 0
109 105 6 10 1 3 51 255 0
113 106 6 8 1 3 51 255 0
119 110 6 8 1 3 51 255 0
123 112 10 7 1 3 51 255 0
117 107 4 9 1 3 51 255 0
119 109 4 12 1 3 51 255 0
182 117 12 13 1 3 51 255 0
193 118 6 7 1 3 51 255 0
198 120 7 9 1 3 51 255 0
203 124 6 12 1 3 51 255 0
203 120 5 9 1 3 51 255 0
208 134 8 10 1 3 51 255 0
207 129 6 10 1 3 51 255 0
215 139 4 8 1 3 51 255 0
219 144 5 8 1 3 51 255 0
221 145 7 9 1 3 51 255 0
236 153 4 9 1 3 51 255 0
237 153 3 8 1 3 51 255 0
238 154 3 10 1 3 51 255 0
239 155 5 5 1 3 51 255 0
245 161 3 6 1 3 51 255 0
244 158 3 6 1 3 51 255 0
255 165 5 7 1 3 51 255 0
261 167 4 6 1 3 51 255 0
264 167 3 6 1 3 51 255 0
265 168 4 4 1 3 51 255 0
272 173 4 6 1 3 51 255 0
275 174 5 5 1 3 51 255 0
284 182 5 7 1 3 51 255 0
299 184 11 7 1 3 51 255 0
318 183 19 11 1 3 51 255 0
322 180 18 9 1 3 51 255 0
341 171 21 20 1 3 51 255 0
348 167 23 13 1 3 51 255 0
345 169 32 11 1 3 51 255 0
362 161 28 20 1 3 51 255 0
360 159 19 20 1 3 51 255 0
359 162 26 22 1 3 51 255 0
368 154 18 15 1 3 51 255 0
367 154 29 18 1 3 51 255 0
369 151 13 11 1 3 51 255 0
371 148 18 18 1 3 51 255 0
376 144 16 18 1 3 51 255 0
379 142 28 17 1 3 51 255 0
392 139 24 25 1 3 51 255 0
396 136 18 18 1 3 51 255 0
393 137 20 13 1 3 51 255 0
399 133 22 20 1 3 51 255 0
402 130 7 5 1 3 51 255 0
418 128 9 22 1 3 51 255 0
0

//file format:

mapWidth mapHeight
spawnPointX spawnPointY
edgeWarpLeftMap edgeWarpRightMap edgeWarpUpMap edgeWarpDownMap //n means none, player just warps to opposite side of current map
numberOfShapesToReadFromTheFile
topLeftCornerX topLeftCornerY width height collision climbability r g b //each of these lines represents one shape
warpCount
warpToMapNum warpToXCoord warpToYCoord //n means warp destination is the same as current map

//collision can be: 0 (no collision, draw behind char), 1 (collision), 2 (no collision, draw in front of char), 3 (no collision oval, draw behind char), 4 (no collision oval, draw in front of char), or 5 (warp. is not drawn, but will teleport the player).
//climbable can be: 0 (can't climb), 1 (can ladder climb, no gravity applies), 2 (can climb, slow gravity applies), or 3 (can jump climb, no gravity applies). anything greater than or eqaul to 10 is to keep track of which warp is assigned to which warp recangle (10 = warp 0, 11 = warp 1, etc.).

