430 210
12 54
10 14 13 12
128
-10 -12 449 232 0 0 255 204 204
298 121 17 98 1 3 51 255 0
366 13 31 32 0 0 51 255 255
368 11 27 10 0 0 51 255 255
394 14 5 30 0 0 51 255 255
367 43 27 4 0 0 51 255 255
364 16 11 29 0 0 51 255 255
362 20 15 21 0 0 51 255 255
371 9 23 13 0 0 51 255 255
360 23 12 15 0 0 51 255 255
397 17 4 23 0 0 51 255 255
369 43 22 6 0 0 51 255 255
372 48 16 2 0 0 51 255 255
374 7 17 7 0 0 51 255 255
367 25 5 5 0 1 0 204 204
375 32 9 8 0 1 0 204 204
375 26 4 3 0 1 0 204 204
370 31 3 3 0 1 0 204 204
377 31 5 4 0 1 0 204 204
382 34 3 3 0 1 0 204 204
376 38 7 3 0 1 0 204 204
373 33 9 6 0 1 0 204 204
370 12 5 4 0 1 0 204 204
389 25 5 3 0 1 0 204 204
389 37 4 4 0 1 0 204 204
363 32 3 2 0 1 255 255 255
389 11 2 2 0 1 255 255 255
383 41 1 1 0 1 255 255 255
373 21 3 1 0 1 255 255 255
370 39 1 2 0 1 255 255 255
394 20 3 2 0 1 255 255 255
361 13 4 3 0 0 204 204 204
355 13 3 3 0 0 204 204 204
359 18 5 4 0 0 204 204 204
367 20 4 3 0 0 204 204 204
366 22 4 4 0 0 204 204 204
373 22 3 5 0 0 204 204 204
369 27 2 6 0 0 204 204 204
378 26 5 4 0 0 204 204 204
373 27 1 3 0 0 204 204 204
377 31 3 2 0 0 204 204 204
361 23 3 3 0 0 204 204 204
352 16 4 3 0 0 204 204 204
385 29 4 4 0 0 204 204 204
382 32 2 4 0 0 204 204 204
391 31 2 3 0 0 204 204 204
387 35 4 2 0 0 204 204 204
394 32 2 3 0 0 204 204 204
393 37 5 3 0 0 204 204 204
400 41 4 4 0 0 204 204 204
401 35 4 3 0 0 204 204 204
407 39 3 3 0 0 204 204 204
398 30 4 3 0 0 220 220 230
384 35 1 3 0 0 220 220 230
354 19 4 3 0 0 220 220 230
380 33 2 1 0 0 220 220 230
382 26 2 2 0 0 220 220 230
384 36 4 3 0 0 220 220 230
406 41 4 2 0 0 220 220 230
-5 130 98 84 1 3 51 255 0
-15 130 57 41 1 3 51 255 0
88 126 69 92 1 3 51 255 0
98 123 95 95 1 3 51 255 0
110 121 195 96 1 3 51 255 0
144 118 150 30 1 3 51 255 0
248 79 5 41 0 2 255 255 153
225 91 5 28 0 2 255 255 153
222 76 6 16 0 2 255 255 153
235 107 4 12 0 2 255 255 153
209 102 5 16 0 2 255 255 153
211 78 5 24 0 2 255 255 153
263 96 5 22 0 2 255 255 153
258 66 7 31 0 2 255 255 153
259 95 7 5 0 2 255 255 153
205 71 14 8 2 1 255 255 153
220 69 13 8 2 1 255 255 153
244 70 11 9 0 1 255 255 153
232 103 10 5 0 2 255 255 153
207 73 9 3 2 1 255 204 102
223 69 5 4 2 1 255 204 102
246 71 6 5 0 1 255 204 102
176 114 6 5 2 0 255 255 153
180 109 11 5 2 0 255 255 153
189 110 6 4 2 0 255 255 153
191 112 8 4 2 0 255 255 153
195 113 7 6 2 0 255 255 153
277 114 6 6 2 0 255 255 153
281 111 10 4 2 0 255 255 153
290 114 8 3 2 0 255 255 153
297 115 6 4 2 0 255 255 153
299 116 6 5 2 0 255 255 153
302 117 6 6 2 0 255 255 153
310 151 6 5 2 0 255 255 153
314 152 8 4 2 0 255 255 153
317 155 5 5 2 0 255 255 153
320 158 4 6 2 0 255 255 153
322 163 2 8 2 0 255 255 153
244 56 36 11 2 1 255 255 153
250 53 24 8 2 1 255 255 153
277 56 7 9 2 1 255 255 153
240 59 12 5 2 1 255 255 153
252 56 18 5 2 1 255 204 102
256 58 9 4 2 1 255 204 102
310 128 5 23 1 3 51 255 0
312 137 4 12 1 3 51 255 0
312 166 5 38 1 0 51 255 0
310 161 5 15 1 0 51 255 0
312 201 4 16 1 0 51 255 0
311 156 5 15 1 0 51 255 0
352 121 85 97 1 3 51 255 0
349 125 34 95 1 3 51 255 0
346 130 37 76 1 3 51 255 0
357 117 79 14 1 3 51 255 0
362 115 74 13 1 3 51 255 0
369 111 69 14 1 3 51 255 0
376 110 62 32 1 3 51 255 0
387 108 49 34 1 3 51 255 0
366 113 40 21 1 3 51 255 0
393 106 49 21 1 3 51 255 0
400 104 39 20 1 3 51 255 0
404 101 39 15 1 3 51 255 0
412 98 30 14 1 3 51 255 0
15 128 75 14 1 3 51 255 0
59 125 5 3 2 0 0 204 0
19 124 4 4 2 0 0 204 0
164 115 4 4 2 0 0 204 0
377 109 4 2 2 0 0 204 0
419 95 5 4 2 0 0 204 0
0

//file format:

mapWidth mapHeight
spawnPointX spawnPointY
edgeWarpLeftMap edgeWarpRightMap edgeWarpUpMap edgeWarpDownMap //n means none, player just warps to opposite side of current map
numberOfShapesToReadFromTheFile
topLeftCornerX topLeftCornerY width height collision climbability r g b //each of these lines represents one shape
warpCount
warpToMapNum warpToXCoord warpToYCoord //n means warp destination is the same as current map

//collision can be: 0 (no collision, draw behind char), 1 (collision), 2 (no collision, draw in front of char), 3 (no collision oval, draw behind char), 4 (no collision oval, draw in front of char), or 5 (warp. is not drawn, but will teleport the player).
//climbable can be: 0 (can't climb), 1 (can ladder climb, no gravity applies), 2 (can climb, slow gravity applies), or 3 (can jump climb, no gravity applies). anything greater than or eqaul to 10 is to keep track of which warp is assigned to which warp recangle (10 = warp 0, 11 = warp 1, etc.).

