430 210
12 54
n n 11 13
107
-10 -12 449 232 0 0 255 204 204
366 13 31 32 0 0 51 255 255
368 11 27 10 0 0 51 255 255
394 14 5 30 0 0 51 255 255
367 43 27 4 0 0 51 255 255
364 16 11 29 0 0 51 255 255
362 20 15 21 0 0 51 255 255
371 9 23 13 0 0 51 255 255
360 23 12 15 0 0 51 255 255
397 17 4 23 0 0 51 255 255
369 43 22 6 0 0 51 255 255
372 48 16 2 0 0 51 255 255
374 7 17 7 0 0 51 255 255
367 25 5 5 0 1 0 204 204
375 32 9 8 0 1 0 204 204
375 26 4 3 0 1 0 204 204
370 31 3 3 0 1 0 204 204
377 31 5 4 0 1 0 204 204
382 34 3 3 0 1 0 204 204
376 38 7 3 0 1 0 204 204
373 33 9 6 0 1 0 204 204
370 12 5 4 0 1 0 204 204
389 25 5 3 0 1 0 204 204
389 37 4 4 0 1 0 204 204
363 32 3 2 0 1 255 255 255
389 11 2 2 0 1 255 255 255
383 41 1 1 0 1 255 255 255
373 21 3 1 0 1 255 255 255
370 39 1 2 0 1 255 255 255
394 20 3 2 0 1 255 255 255
361 13 4 3 0 0 204 204 204
355 13 3 3 0 0 204 204 204
359 18 5 4 0 0 204 204 204
367 20 4 3 0 0 204 204 204
366 22 4 4 0 0 204 204 204
373 22 3 5 0 0 204 204 204
369 27 2 6 0 0 204 204 204
378 26 5 4 0 0 204 204 204
373 27 1 3 0 0 204 204 204
377 31 3 2 0 0 204 204 204
361 23 3 3 0 0 204 204 204
352 16 4 3 0 0 204 204 204
385 29 4 4 0 0 204 204 204
382 32 2 4 0 0 204 204 204
391 31 2 3 0 0 204 204 204
387 35 4 2 0 0 204 204 204
394 32 2 3 0 0 204 204 204
393 37 5 3 0 0 204 204 204
400 41 4 4 0 0 204 204 204
401 35 4 3 0 0 204 204 204
407 39 3 3 0 0 204 204 204
398 30 4 3 0 0 220 220 230
384 35 1 3 0 0 220 220 230
354 19 4 3 0 0 220 220 230
380 33 2 1 0 0 220 220 230
382 26 2 2 0 0 220 220 230
384 36 4 3 0 0 220 220 230
406 41 4 2 0 0 220 220 230
-5 130 98 84 1 1 51 255 0
-15 130 57 41 1 1 51 255 0
88 126 69 92 1 1 51 255 0
98 123 95 95 1 1 51 255 0
110 121 195 96 1 1 51 255 0
144 118 150 30 1 1 51 255 0
310 128 5 23 2 0 51 255 0
312 137 4 12 2 0 51 255 0
352 121 85 97 1 1 51 255 0
357 117 79 14 1 1 51 255 0
362 115 74 13 1 1 51 255 0
369 111 69 14 1 1 51 255 0
376 110 62 32 1 1 51 255 0
387 108 49 34 1 1 51 255 0
366 113 40 21 1 1 51 255 0
393 106 49 21 1 1 51 255 0
400 104 39 20 1 1 51 255 0
404 101 39 15 1 1 51 255 0
412 98 30 14 1 1 51 255 0
15 128 75 14 1 1 51 255 0
-3 -9 314 177 1 0 51 255 0
351 -8 92 140 1 0 51 255 0
303 -14 10 18 1 0 51 255 0
305 85 9 59 1 0 51 255 0
306 63 7 35 1 0 51 255 0
346 117 16 33 1 0 51 255 0
345 98 16 29 1 0 51 255 0
343 86 24 31 1 0 51 255 0
344 80 24 23 1 0 51 255 0
344 76 23 15 1 0 51 255 0
345 70 24 17 1 0 51 255 0
345 64 43 40 1 0 51 255 0
345 60 22 17 1 0 51 255 0
347 57 41 41 1 0 51 255 0
346 49 63 61 1 0 51 255 0
347 40 28 43 1 0 51 255 0
348 35 26 26 1 0 51 255 0
347 29 38 43 1 0 51 255 0
348 24 27 29 1 0 51 255 0
348 21 24 24 1 0 51 255 0
348 16 42 52 1 0 51 255 0
349 13 22 23 1 0 51 255 0
308 146 6 35 1 0 51 255 0
298 161 14 51 1 0 51 255 0
298 205 15 15 1 0 51 255 0
346 145 14 36 1 0 51 255 0
347 176 20 19 1 0 51 255 0
348 189 12 22 1 0 51 255 0
347 205 9 16 1 0 51 255 0
0

//file format:

mapWidth mapHeight
spawnPointX spawnPointY
numberOfRectanglesToReadFromTheFile
topLeftCornerX topLeftCornerY width height collision climbable r g b //each of these lines represents one rectangle

//collision can be: 0 (no collision, draw behind char), 1 (collision), 2 (no collision, draw in front of char), 3 (no collision oval, draw behind char), or 4 (no collision oval, draw in front of char)
//climbable can be: 0 (can't climb), 1 (can climb, no gravity applies), or 2 (can climb, slow gravity applies)

