430 210
12 54
n n 12 16
208
-10 -12 449 232 0 0 255 204 204
98 123 95 95 1 1 51 255 0
-6 -5 295 154 1 0 51 255 0
78 119 17 13 1 0 255 204 204
366 13 31 32 0 0 51 255 255
368 11 27 10 0 0 51 255 255
394 14 5 30 0 0 51 255 255
367 43 27 4 0 0 51 255 255
364 16 11 29 0 0 51 255 255
362 20 15 21 0 0 51 255 255
371 9 23 13 0 0 51 255 255
360 23 12 15 0 0 51 255 255
397 17 4 23 0 0 51 255 255
369 43 22 6 0 0 51 255 255
372 48 16 2 0 0 51 255 255
374 7 17 7 0 0 51 255 255
367 25 5 5 0 1 0 204 204
375 32 9 8 0 1 0 204 204
375 26 4 3 0 1 0 204 204
370 31 3 3 0 1 0 204 204
377 31 5 4 0 1 0 204 204
382 34 3 3 0 1 0 204 204
376 38 7 3 0 1 0 204 204
373 33 9 6 0 1 0 204 204
370 12 5 4 0 1 0 204 204
389 25 5 3 0 1 0 204 204
389 37 4 4 0 1 0 204 204
363 32 3 2 0 1 255 255 255
389 11 2 2 0 1 255 255 255
383 41 1 1 0 1 255 255 255
373 21 3 1 0 1 255 255 255
370 39 1 2 0 1 255 255 255
394 20 3 2 0 1 255 255 255
361 13 4 3 0 0 204 204 204
355 13 3 3 0 0 204 204 204
359 18 5 4 0 0 204 204 204
367 20 4 3 0 0 204 204 204
366 22 4 4 0 0 204 204 204
373 22 3 5 0 0 204 204 204
369 27 2 6 0 0 204 204 204
378 26 5 4 0 0 204 204 204
373 27 1 3 0 0 204 204 204
377 31 3 2 0 0 204 204 204
361 23 3 3 0 0 204 204 204
352 16 4 3 0 0 204 204 204
385 29 4 4 0 0 204 204 204
382 32 2 4 0 0 204 204 204
391 31 2 3 0 0 204 204 204
387 35 4 2 0 0 204 204 204
394 32 2 3 0 0 204 204 204
393 37 5 3 0 0 204 204 204
400 41 4 4 0 0 204 204 204
401 35 4 3 0 0 204 204 204
407 39 3 3 0 0 204 204 204
398 30 4 3 0 0 220 220 230
384 35 1 3 0 0 220 220 230
354 19 4 3 0 0 220 220 230
380 33 2 1 0 0 220 220 230
382 26 2 2 0 0 220 220 230
384 36 4 3 0 0 220 220 230
406 41 4 2 0 0 220 220 230
-5 130 98 84 1 1 51 255 0
-15 130 57 41 1 1 51 255 0
88 126 69 92 1 1 51 255 0
362 115 74 13 1 1 51 255 0
369 111 69 14 1 1 51 255 0
376 110 62 32 1 1 51 255 0
387 108 49 34 1 1 51 255 0
366 113 40 21 1 1 51 255 0
393 106 49 21 1 1 51 255 0
400 104 39 20 1 1 51 255 0
404 101 39 15 1 1 51 255 0
412 98 30 14 1 1 51 255 0
15 128 75 14 1 1 51 255 0
348 35 26 26 1 0 51 255 0
348 21 24 24 1 0 51 255 0
283 -2 29 39 1 0 51 255 0
348 -4 87 106 1 0 51 255 0
281 29 30 93 1 0 51 255 0
346 20 25 68 1 0 51 255 0
347 99 89 60 1 0 51 255 0
263 108 50 66 1 0 51 255 0
257 167 53 10 1 0 51 255 0
266 173 42 7 1 0 51 255 0
265 173 40 10 1 0 51 255 0
346 156 39 28 1 0 51 255 0
348 180 44 9 1 0 51 255 0
350 185 39 8 1 0 51 255 0
351 190 35 4 1 0 51 255 0
358 189 44 8 1 0 51 255 0
354 191 9 5 1 0 51 255 0
363 193 72 23 1 0 51 255 0
377 155 57 50 1 0 51 255 0
358 192 15 13 1 0 51 255 0
354 192 9 7 1 0 51 255 0
360 202 13 10 1 0 51 255 0
223 164 80 22 1 0 51 255 0
258 178 43 13 1 0 51 255 0
249 181 51 16 1 0 51 255 0
253 190 43 9 1 0 51 255 0
247 192 46 10 1 0 51 255 0
233 197 60 5 1 0 51 255 0
245 190 43 14 1 0 51 255 0
241 200 43 6 1 0 51 255 0
223 200 56 8 1 0 51 255 0
211 208 64 8 1 0 51 255 0
180 137 92 41 1 0 51 255 0
181 168 74 31 1 0 51 255 0
195 188 34 25 1 0 51 255 0
162 184 62 35 1 0 51 255 0
91 104 52 7 1 0 255 204 204
144 112 6 26 1 0 255 204 204
89 139 54 4 1 0 255 204 204
83 110 11 30 1 0 255 204 204
81 114 12 20 1 0 255 204 204
75 121 10 9 1 0 255 204 204
75 129 18 12 1 0 255 204 204
73 124 14 15 1 0 255 204 204
70 127 17 8 1 0 255 204 204
86 108 61 34 1 0 255 204 204
68 114 117 33 0 2 0 153 51
157 113 48 50 0 2 51 255 0
59 110 23 9 0 2 51 255 0
70 116 10 9 0 2 51 255 0
64 115 14 12 0 2 51 255 0
67 124 10 8 0 2 51 255 0
62 130 13 4 0 2 51 255 0
61 132 14 21 0 2 51 255 0
149 112 22 10 0 2 51 255 0
151 119 15 11 0 2 51 255 0
148 129 21 4 0 2 51 255 0
142 131 22 6 0 2 51 255 0
125 135 43 15 0 2 51 255 0
117 135 26 11 0 2 51 255 0
109 137 37 11 0 2 51 255 0
94 136 31 12 0 2 51 255 0
85 135 14 12 0 2 51 255 0
79 134 7 7 0 2 51 255 0
74 133 9 15 0 2 51 255 0
78 140 17 14 0 2 51 255 0
224 195 33 6 0 2 51 255 0
70 132 9 6 0 2 51 255 0
70 126 8 7 0 2 51 255 0
72 130 7 5 0 2 51 255 0
72 122 7 7 0 2 51 255 0
86 99 9 7 0 2 51 255 0
138 101 17 4 0 2 51 255 0
126 132 5 3 0 2 0 204 0
90 132 4 3 0 2 0 204 0
199 39 45 23 0 2 255 204 204
198 51 46 12 0 2 0 153 51
190 33 19 8 0 2 51 255 0
190 37 15 7 0 2 51 255 0
186 44 15 3 0 2 51 255 0
188 50 12 4 0 2 51 255 0
194 56 3 6 0 2 51 255 0
194 58 9 8 0 2 51 255 0
201 59 12 6 0 2 51 255 0
211 60 14 4 0 2 51 255 0
224 60 14 4 0 2 51 255 0
221 57 13 5 0 2 51 255 0
237 59 14 7 0 2 51 255 0
240 48 14 12 0 2 51 255 0
238 43 22 8 0 2 51 255 0
235 37 18 8 0 2 51 255 0
221 36 21 7 0 2 51 255 0
207 37 25 5 0 2 51 255 0
199 39 12 3 0 2 51 255 0
232 58 17 8 0 2 51 255 0
393 106 21 10 0 2 255 204 204
24 6 27 7 0 2 255 204 204
411 114 12 8 0 2 51 255 0
388 111 13 11 0 2 51 255 0
390 101 6 6 0 2 51 255 0
409 101 14 7 0 2 51 255 0
398 112 5 8 0 2 51 255 0
401 114 9 6 0 2 51 255 0
23 8 7 9 0 2 51 255 0
43 10 12 9 0 2 51 255 0
24 4 11 3 0 2 51 255 0
40 2 14 6 0 2 51 255 0
44 179 57 12 0 2 255 204 204
43 183 58 10 0 2 0 153 51
96 171 24 14 0 2 51 255 0
98 183 12 5 0 2 51 255 0
96 190 15 5 0 2 51 255 0
38 183 9 13 0 2 51 255 0
39 175 11 10 0 2 51 255 0
45 190 8 7 0 2 51 255 0
51 190 12 4 0 2 51 255 0
61 191 19 4 0 2 51 255 0
79 190 13 5 0 2 51 255 0
91 190 12 6 0 2 51 255 0
82 176 21 5 0 2 51 255 0
44 174 19 8 0 2 51 255 0
271 156 7 28 0 2 255 204 204
259 141 14 24 0 2 51 255 0
266 165 3 13 0 2 51 255 0
269 182 6 5 0 2 51 255 0
275 171 11 13 0 2 51 255 0
276 164 13 13 0 2 51 255 0
275 154 7 9 0 2 51 255 0
269 170 2 10 0 2 51 255 0
268 148 27 15 0 2 51 255 0
276 157 16 17 0 2 51 255 0
265 168 7 11 0 2 51 255 0
19 1 224 158 1 0 51 255 0
66 188 4 3 1 0 0 205 0
0

//file format:

mapWidth mapHeight
spawnPointX spawnPointY
numberOfRectanglesToReadFromTheFile
topLeftCornerX topLeftCornerY width height collision climbable r g b //each of these lines represents one rectangle
warpCount
warpToMapNum warpToXCoord warpToYCoord

//collision can be: 0 (no collision, draw behind char), 1 (collision), 2 (no collision, draw in front of char), 3 (no collision oval, draw behind char), 4 (no collision oval, draw in front of char), or 5 (warp. is not drawn, but will teleport the player).
//climbable can be: 0 (can't climb), 1 (can climb, no gravity applies), or 2 (can climb, slow gravity applies). anything greater than or eqaul to 10 is to keep track of which warp is assigned to which warp recangle (10 = warp 0, 11 = warp 1, etc.).

