430 210
12 54
11 10 13 16
152
-10 -12 449 232 0 0 255 204 204
298 121 17 98 1 0 51 255 0
366 13 31 32 0 0 51 255 255
368 11 27 10 0 0 51 255 255
394 14 5 30 0 0 51 255 255
367 43 27 4 0 0 51 255 255
364 16 11 29 0 0 51 255 255
362 20 15 21 0 0 51 255 255
371 9 23 13 0 0 51 255 255
360 23 12 15 0 0 51 255 255
397 17 4 23 0 0 51 255 255
369 43 22 6 0 0 51 255 255
372 48 16 2 0 0 51 255 255
374 7 17 7 0 0 51 255 255
367 25 5 5 0 1 0 204 204
375 32 9 8 0 1 0 204 204
375 26 4 3 0 1 0 204 204
370 31 3 3 0 1 0 204 204
377 31 5 4 0 1 0 204 204
382 34 3 3 0 1 0 204 204
376 38 7 3 0 1 0 204 204
373 33 9 6 0 1 0 204 204
370 12 5 4 0 1 0 204 204
389 25 5 3 0 1 0 204 204
389 37 4 4 0 1 0 204 204
363 32 3 2 0 1 255 255 255
389 11 2 2 0 1 255 255 255
383 41 1 1 0 1 255 255 255
373 21 3 1 0 1 255 255 255
370 39 1 2 0 1 255 255 255
394 20 3 2 0 1 255 255 255
361 13 4 3 0 0 204 204 204
355 13 3 3 0 0 204 204 204
359 18 5 4 0 0 204 204 204
367 20 4 3 0 0 204 204 204
366 22 4 4 0 0 204 204 204
373 22 3 5 0 0 204 204 204
369 27 2 6 0 0 204 204 204
378 26 5 4 0 0 204 204 204
373 27 1 3 0 0 204 204 204
377 31 3 2 0 0 204 204 204
361 23 3 3 0 0 204 204 204
352 16 4 3 0 0 204 204 204
385 29 4 4 0 0 204 204 204
382 32 2 4 0 0 204 204 204
391 31 2 3 0 0 204 204 204
387 35 4 2 0 0 204 204 204
394 32 2 3 0 0 204 204 204
393 37 5 3 0 0 204 204 204
400 41 4 4 0 0 204 204 204
401 35 4 3 0 0 204 204 204
407 39 3 3 0 0 204 204 204
398 30 4 3 0 0 220 220 230
384 35 1 3 0 0 220 220 230
354 19 4 3 0 0 220 220 230
380 33 2 1 0 0 220 220 230
382 26 2 2 0 0 220 220 230
384 36 4 3 0 0 220 220 230
406 41 4 2 0 0 220 220 230
-5 130 98 84 1 1 51 255 0
-15 130 57 41 1 1 51 255 0
88 126 69 92 1 1 51 255 0
98 123 95 95 1 1 51 255 0
110 121 195 96 1 1 51 255 0
144 118 150 30 1 1 51 255 0
310 128 5 23 2 0 51 255 0
312 137 4 12 2 0 51 255 0
312 166 5 38 2 0 51 255 0
310 161 5 15 2 0 51 255 0
312 201 4 16 2 0 51 255 0
311 156 5 15 2 0 51 255 0
352 121 85 97 1 1 51 255 0
349 125 34 95 1 1 51 255 0
346 130 37 76 1 0 51 255 0
357 117 79 14 1 1 51 255 0
362 115 74 13 1 1 51 255 0
369 111 69 14 1 1 51 255 0
376 110 62 32 1 1 51 255 0
387 108 49 34 1 1 51 255 0
366 113 40 21 1 1 51 255 0
393 106 49 21 1 1 51 255 0
400 104 39 20 1 1 51 255 0
404 101 39 15 1 1 51 255 0
412 98 30 14 1 1 51 255 0
15 128 75 14 1 1 51 255 0
-12 98 42 6 1 3 51 255 0
17 97 46 7 1 3 51 255 0
37 96 53 13 1 3 51 255 0
82 95 33 9 1 3 51 255 0
113 96 21 10 1 3 51 255 0
131 97 36 12 1 3 51 255 0
165 99 68 15 1 3 51 255 0
229 100 38 19 1 3 51 255 0
250 99 56 18 1 3 51 255 0
266 98 47 22 1 3 51 255 0
275 95 75 36 1 3 51 255 0
253 152 139 66 1 0 51 255 0
-13 102 258 45 1 3 51 255 0
19 93 5 4 2 0 0 204 0
104 92 4 4 2 0 0 204 0
252 96 6 5 2 0 0 204 0
339 93 100 73 1 3 51 255 0
304 126 75 41 1 1 51 255 0
404 91 39 22 1 3 51 255 0
406 90 32 26 1 3 51 255 0
408 88 32 18 1 3 51 255 0
412 85 28 15 1 3 51 255 0
411 86 27 30 1 3 51 255 0
413 83 28 21 1 3 51 255 0
414 80 24 14 1 3 51 255 0
417 66 25 25 1 3 51 255 0
416 72 20 28 1 3 51 255 0
419 56 21 15 1 3 51 255 0
416 54 16 22 1 3 51 255 0
414 74 25 41 1 3 51 255 0
413 79 22 38 1 3 51 255 0
409 86 33 40 1 3 51 255 0
420 33 21 25 1 0 51 255 0
421 25 20 12 1 0 51 255 0
423 21 17 14 1 0 51 255 0
425 12 15 19 1 0 51 255 0
427 8 14 20 1 0 51 255 0
427 4 14 11 1 0 51 255 0
427 -1 13 16 1 0 51 255 0
425 7 18 19 1 0 51 255 0
423 15 14 40 1 0 51 255 0
401 90 21 20 1 0 51 255 0
414 66 18 45 1 3 51 255 0
386 91 31 28 1 3 51 255 0
421 18 15 36 1 0 51 255 0
421 8 16 36 1 0 51 255 0
422 -2 18 37 1 0 51 255 0
421 0 14 57 1 0 51 255 0
418 42 20 51 1 0 51 255 0
412 73 22 43 1 3 51 255 0
409 84 27 57 1 3 51 255 0
409 80 21 31 1 3 51 255 0
398 88 24 16 1 3 51 255 0
406 85 19 24 1 3 51 255 0
396 89 18 15 1 3 51 255 0
401 85 5 3 2 0 0 204 0
373 91 5 2 2 0 0 204 0
345 90 5 3 2 0 0 204 0
393 88 3 2 2 0 0 204 0
361 92 3 1 2 0 0 204 0
354 90 3 3 2 0 0 204 0
387 89 2 3 2 0 0 204 0
318 92 3 2 2 0 0 204 0
334 94 3 2 2 0 0 204 0
418 41 2 1 2 0 0 204 0
416 53 2 1 2 0 0 204 0
413 66 2 1 2 0 0 204 0
0

//file format:

mapWidth mapHeight
spawnPointX spawnPointY
edgeWarpLeftMap edgeWarpRightMap edgeWarpUpMap edgeWarpDownMap //n means none, player just warps to opposite side of current map
numberOfShapesToReadFromTheFile
topLeftCornerX topLeftCornerY width height collision climbability r g b //each of these lines represents one shape
warpCount
warpToMapNum warpToXCoord warpToYCoord //n means warp destination is the same as current map

//collision can be: 0 (no collision, draw behind char), 1 (collision), 2 (no collision, draw in front of char), 3 (no collision oval, draw behind char), 4 (no collision oval, draw in front of char), or 5 (warp. is not drawn, but will teleport the player).
//climbable can be: 0 (can't climb), 1 (can ladder climb, no gravity applies), 2 (can climb, slow gravity applies), or 3 (can jump climb, no gravity applies). anything greater than or eqaul to 10 is to keep track of which warp is assigned to which warp recangle (10 = warp 0, 11 = warp 1, etc.).

