430 210
65 128
n 10 n n
243
39 80 15 70 5 10 153 0 153
45 129 30 12 1 0 200 200 200
-10 -12 449 232 0 0 255 204 204
52 156 103 61 1 1 51 255 0
152 164 104 55 1 1 51 255 0
252 167 11 11 1 1 51 255 0
259 170 13 10 1 1 51 255 0
269 175 13 9 1 1 51 255 0
251 173 16 44 1 1 51 255 0
265 177 18 40 1 1 51 255 0
276 185 62 30 1 1 51 255 0
332 177 37 36 1 1 51 255 0
327 179 32 24 1 1 51 255 0
323 181 30 15 1 1 51 255 0
280 180 6 17 1 1 51 255 0
338 174 51 29 1 1 51 255 0
343 170 94 45 1 1 51 255 0
350 163 90 44 1 1 51 255 0
371 147 71 55 1 1 51 255 0
363 155 63 30 1 1 51 255 0
385 140 44 28 1 1 51 255 0
403 130 37 31 1 1 51 255 0
150 159 33 14 1 1 51 255 0
228 149 7 28 1 1 51 255 0
232 152 6 24 1 1 51 255 0
235 157 12 10 1 1 51 255 0
366 13 31 32 0 0 51 255 255
368 11 27 10 0 0 51 255 255
394 14 5 30 0 0 51 255 255
367 43 27 4 0 0 51 255 255
364 16 11 29 0 0 51 255 255
362 20 15 21 0 0 51 255 255
371 9 23 13 0 0 51 255 255
360 23 12 15 0 0 51 255 255
397 17 4 23 0 0 51 255 255
369 43 22 6 0 0 51 255 255
372 48 16 2 0 0 51 255 255
374 7 17 7 0 0 51 255 255
367 25 5 5 0 1 0 204 204
375 32 9 8 0 1 0 204 204
375 26 4 3 0 1 0 204 204
370 31 3 3 0 1 0 204 204
377 31 5 4 0 1 0 204 204
382 34 3 3 0 1 0 204 204
376 38 7 3 0 1 0 204 204
373 33 9 6 0 1 0 204 204
370 12 5 4 0 1 0 204 204
389 25 5 3 0 1 0 204 204
389 37 4 4 0 1 0 204 204
363 32 3 2 0 1 255 255 255
389 11 2 2 0 1 255 255 255
383 41 1 1 0 1 255 255 255
373 21 3 1 0 1 255 255 255
370 39 1 2 0 1 255 255 255
394 20 3 2 0 1 255 255 255
361 13 4 3 0 0 204 204 204
355 13 3 3 0 0 204 204 204
359 18 5 4 0 0 204 204 204
367 20 4 3 0 0 204 204 204
366 22 4 4 0 0 204 204 204
373 22 3 5 0 0 204 204 204
369 27 2 6 0 0 204 204 204
378 26 5 4 0 0 204 204 204
373 27 1 3 0 0 204 204 204
377 31 3 2 0 0 204 204 204
361 23 3 3 0 0 204 204 204
352 16 4 3 0 0 204 204 204
385 29 4 4 0 0 204 204 204
382 32 2 4 0 0 204 204 204
391 31 2 3 0 0 204 204 204
387 35 4 2 0 0 204 204 204
394 32 2 3 0 0 204 204 204
393 37 5 3 0 0 204 204 204
400 41 4 4 0 0 204 204 204
401 35 4 3 0 0 204 204 204
407 39 3 3 0 0 204 204 204
398 30 4 3 0 0 220 220 230
384 35 1 3 0 0 220 220 230
354 19 4 3 0 0 220 220 230
380 33 2 1 0 0 220 220 230
382 26 2 2 0 0 220 220 230
384 36 4 3 0 0 220 220 230
406 41 4 2 0 0 220 220 230
375 74 59 5 1 3 51 255 0
288 171 73 23 0 3 51 255 0
324 80 69 5 1 3 51 255 0
359 77 44 5 1 3 51 255 0
299 86 60 6 1 3 51 255 0
313 82 50 9 1 3 51 255 0
308 84 18 4 1 3 51 255 0
123 138 143 4 1 3 51 255 0
229 135 124 5 1 3 51 255 0
231 133 129 13 1 3 51 255 0
233 130 143 7 1 3 51 255 0
237 128 119 8 1 3 51 255 0
248 124 129 8 1 3 51 255 0
244 125 73 14 1 3 51 255 0
267 119 142 8 1 3 51 255 0
259 122 59 5 1 3 51 255 0
271 115 147 8 1 3 51 255 0
275 110 139 13 1 3 51 255 0
281 106 103 10 1 3 51 255 0
289 102 122 25 1 3 51 255 0
293 99 113 26 1 3 51 255 0
297 95 126 15 1 3 51 255 0
297 90 77 15 1 3 51 255 0
363 85 79 28 1 3 51 255 0
397 74 46 17 1 3 51 255 0
384 80 37 13 1 3 51 255 0
407 106 35 45 1 1 51 255 0
270 139 143 53 1 1 51 255 0
364 121 50 45 1 1 51 255 0
335 106 57 47 1 1 51 255 0
232 139 73 45 1 3 51 255 0
76 132 49 9 1 3 51 255 0
121 134 23 11 1 3 51 255 0
66 128 19 13 1 0 51 255 0
53 130 20 7 1 1 51 255 0
70 130 15 7 1 0 51 255 0
48 128 18 6 1 1 51 255 0
14 122 22 8 1 1 51 255 0
33 123 12 8 1 1 51 255 0
43 124 6 7 1 1 51 255 0
-1 115 13 10 1 1 51 255 0
8 115 10 21 1 1 51 255 0
15 117 11 9 1 1 51 255 0
23 118 12 9 1 1 51 255 0
32 120 7 5 1 1 51 255 0
131 141 128 20 0 3 51 255 0
-9 118 30 22 1 1 51 255 0
0 132 139 35 0 3 51 255 0
3 125 51 13 1 1 51 255 0
165 149 104 24 0 3 51 255 0
294 95 50 25 0 3 51 255 0
302 84 33 19 0 3 51 255 0
-10 137 95 81 1 1 51 255 0
44 108 30 19 0 0 102 102 102
41 111 14 14 0 0 102 102 102
46 105 24 7 2 0 102 102 102
69 111 6 14 0 0 102 102 102
45 102 5 5 0 0 102 102 102
42 97 6 6 0 0 102 102 102
40 92 6 7 0 0 102 102 102
69 102 4 7 0 0 102 102 102
71 98 4 4 0 0 102 102 102
74 94 4 3 0 0 102 102 102
73 95 4 5 0 0 102 102 102
36 120 2 3 0 0 0 0 0
32 120 3 2 0 0 0 0 0
37 122 2 3 0 0 0 0 0
39 124 2 2 0 0 0 0 0
43 123 3 3 0 0 0 0 0
48 128 5 3 0 0 0 0 0
57 128 3 2 0 0 0 0 0
53 132 4 2 0 0 0 0 0
60 129 4 2 0 0 0 0 0
66 128 5 2 0 0 0 0 0
60 133 4 4 0 0 0 0 0
67 132 6 2 0 0 0 0 0
74 128 3 3 0 0 0 0 0
79 128 4 2 0 0 0 0 0
77 132 2 2 0 0 0 0 0
35 130 3 2 0 0 0 0 0
48 135 3 2 0 0 0 0 0
68 137 4 3 0 0 0 0 0
80 134 3 2 0 0 0 0 0
37 135 2 2 0 0 0 0 0
27 124 3 3 0 0 0 0 0
46 112 26 13 2 0 153 153 153
49 108 20 8 2 0 153 153 153
52 122 3 3 2 0 0 0 0
59 124 5 3 2 0 0 0 0
68 122 3 3 2 0 0 0 0
42 116 3 3 2 0 0 0 0
72 116 2 4 2 0 0 0 0
47 116 3 3 2 0 0 0 0
60 121 4 1 2 0 0 0 0
54 136 3 3 2 0 0 0 0
75 91 8 4 0 0 102 102 102
36 89 10 4 0 0 102 102 102
49 102 23 1 1 0 102 102 102
69 107 4 5 2 0 102 102 102
44 109 5 4 2 0 102 102 102
72 113 3 12 2 0 102 102 102
41 111 5 16 1 0 102 102 102
45 125 29 4 2 0 102 102 102
49 125 2 2 2 0 0 0 0
66 127 2 1 2 0 0 0 0
60 128 4 2 2 0 0 0 0
49 128 3 1 2 0 0 0 0
67 128 3 1 2 0 0 0 0
54 124 2 1 2 0 0 0 0
55 125 3 2 2 0 0 0 0
66 81 29 19 0 0 255 204 204
106 124 3 3 2 0 102 102 102
106 125 4 3 2 0 102 102 102
108 127 3 5 2 0 102 102 102
110 131 4 2 2 0 102 102 102
104 118 2 6 2 0 102 102 102
104 120 4 4 2 0 102 102 102
149 133 5 3 2 0 102 102 102
151 134 5 4 2 0 102 102 102
189 131 8 4 2 0 102 102 102
186 132 5 4 2 0 102 102 102
185 136 4 3 2 0 102 102 102
7 112 5 3 2 0 102 102 102
23 117 5 4 2 0 102 102 102
222 136 4 4 2 0 102 102 102
66 108 5 5 2 0 153 153 153
47 109 4 4 2 0 153 153 153
48 107 3 4 2 0 153 153 153
50 107 18 1 2 0 153 153 153
49 103 21 2 2 0 102 102 102
66 108 5 1 2 0 102 102 102
68 107 4 4 2 0 102 102 102
47 106 3 3 2 0 102 102 102
45 109 4 2 2 0 102 102 102
73 97 5 3 2 0 102 102 102
70 108 5 5 2 0 102 102 102
72 112 4 4 2 0 102 102 102
73 114 3 10 2 0 102 102 102
72 123 3 5 2 0 102 102 102
71 117 4 2 2 0 0 0 0
41 112 5 14 2 0 102 102 102
42 127 3 3 0 0 0 0 0
43 123 4 3 2 0 0 0 0
41 118 3 3 2 0 0 0 0
44 108 4 5 1 0 102 102 102
98 130 3 3 2 0 0 204 0
208 136 4 3 2 0 0 204 0
339 78 5 2 2 0 0 204 0
393 71 4 3 2 0 0 204 0
416 71 5 3 2 0 0 204 0
54 87 10 16 3 0 153 153 153
50 76 13 14 3 0 153 153 153
37 65 22 19 3 0 153 153 153
23 56 28 22 3 0 153 153 153
5 50 29 29 3 0 153 153 153
-8 45 27 36 3 0 153 153 153
48 103 22 4 2 0 102 102 102
67 103 6 8 2 0 102 102 102
82 129 9 16 1 0 51 255 0
88 130 9 8 1 0 51 255 0
1
19 248 140

//file format:

mapWidth mapHeight
spawnPointX spawnPointY
edgeWarpLeftMap edgeWarpRightMap edgeWarpUpMap edgeWarpDownMap //n means none, player just warps to opposite side of current map
numberOfShapesToReadFromTheFile
topLeftCornerX topLeftCornerY width height collision climbability r g b //each of these lines represents one shape
warpCount
warpToMapNum warpToXCoord warpToYCoord //n means warp destination is the same as current map

//collision can be: 0 (no collision, draw behind char), 1 (collision), 2 (no collision, draw in front of char), 3 (no collision oval, draw behind char), 4 (no collision oval, draw in front of char), or 5 (warp. is not drawn, but will teleport the player).
//climbable can be: 0 (can't climb), 1 (can ladder climb, no gravity applies), 2 (can climb, slow gravity applies), or 3 (can jump climb, no gravity applies). anything greater than or eqaul to 10 is to keep track of which warp is assigned to which warp recangle (10 = warp 0, 11 = warp 1, etc.).

