170 190
40 100
n n n n
15
-5 -7 448 224 0 0 0 180 255
0 100 200 200 1 0 0 170 80
125 20 20 20 3 0 255 255 0
95 60 60 40 0 0 130 100 80
105 76 16 24 0 0 180 140 120
20 85 15 15 3 0 0 120 0
45 85 15 15 3 0 0 120 0
70 85 15 15 3 0 0 120 0
160 85 15 15 3 0 0 120 0
121 60 34 40 2 0 130 100 80
105 60 50 16 2 0 130 100 80
130 73 6 6 2 0 40 40 170
137 73 6 6 2 0 40 40 170
130 80 6 6 2 0 40 40 170
137 80 6 6 2 0 40 40 170
0
