800 800
329 73
30 31 n n
136
-9 91 819 718 0 0 71 35 0
-9 92 392 53 1 2 117 58 0
408 92 400 54 1 2 117 58 0
235 176 220 34 1 2 117 58 0
451 203 90 33 1 2 117 58 0
488 138 152 40 1 2 117 58 0
166 140 34 94 1 2 117 58 0
187 259 230 29 1 2 117 58 0
172 211 28 66 1 2 117 58 0
235 202 217 23 1 2 117 58 0
451 228 34 75 1 2 117 58 0
375 322 118 26 1 2 117 58 0
452 298 36 42 1 2 117 58 0
451 298 31 48 1 2 117 58 0
-4 142 195 162 1 2 117 58 0
166 294 25 83 1 2 117 58 0
230 322 242 39 1 2 117 58 0
114 415 207 75 1 2 117 58 0
230 354 71 90 1 2 117 58 0
20 375 53 339 1 2 117 58 0
-5 297 184 80 1 2 117 58 0
63 527 483 74 1 2 117 58 0
290 359 142 131 1 2 117 58 0
471 536 109 131 1 2 117 58 0
471 466 115 108 1 2 117 58 0
507 430 95 76 1 2 117 58 0
568 411 97 84 1 2 117 58 0
702 415 102 221 1 2 117 58 0
589 488 43 151 1 2 117 58 0
666 531 144 277 1 2 117 58 0
422 354 54 70 1 2 117 58 0
467 343 68 51 1 2 117 58 0
478 228 89 139 1 2 117 58 0
559 165 167 25 1 2 117 58 0
552 243 149 106 1 2 117 58 0
587 186 182 21 1 2 117 58 0
634 142 173 51 1 2 117 58 0
729 260 41 63 1 2 117 58 0
724 199 82 23 1 2 117 58 0
759 180 49 25 1 2 117 58 0
793 219 15 205 1 2 117 58 0
585 392 80 32 1 2 117 58 0
564 239 114 20 1 2 117 58 0
723 387 75 94 1 2 117 58 0
748 358 54 62 1 2 117 58 0
655 409 15 77 1 2 117 58 0
554 501 67 154 1 2 117 58 0
621 509 13 115 1 2 117 58 0
-7 368 73 437 1 2 117 58 0
62 712 150 95 1 2 117 58 0
57 589 186 46 1 2 117 58 0
63 645 12 63 1 2 117 58 0
119 706 207 76 1 2 117 58 0
234 595 241 19 1 2 117 58 0
54 628 249 118 1 2 117 58 0
234 595 261 97 1 2 117 58 0
194 761 491 47 1 2 117 58 0
281 672 45 43 1 2 117 58 0
488 655 79 28 1 2 117 58 0
601 743 106 38 1 2 117 58 0
574 754 83 29 1 2 117 58 0
656 731 55 46 1 2 117 58 0
66 384 9 139 1 2 117 58 0
183 296 11 68 1 2 117 58 0
191 315 6 33 1 2 117 58 0
191 143 14 21 1 2 117 58 0
199 164 4 28 1 2 117 58 0
200 192 1 51 1 2 117 58 0
199 243 3 25 1 2 117 58 0
189 287 11 29 1 2 117 58 0
692 256 11 83 1 2 117 58 0
726 262 26 22 1 2 117 58 0
728 303 23 14 1 2 117 58 0
728 259 46 15 1 2 117 58 0
768 273 5 28 1 2 117 58 0
735 317 20 7 1 2 117 58 0
433 138 53 11 1 2 117 58 0
481 144 37 18 1 2 117 58 0
482 160 19 9 1 2 117 58 0
486 168 17 7 1 2 117 58 0
201 140 169 7 1 2 117 58 0
64 515 13 56 1 2 117 58 0
75 524 307 22 1 2 117 58 0
427 415 13 43 1 2 117 58 0
429 454 9 16 1 2 117 58 0
430 470 5 11 1 2 117 58 0
560 340 11 19 1 2 117 58 0
530 364 20 17 1 2 117 58 0
531 380 13 8 1 2 117 58 0
469 389 11 25 1 2 117 58 0
435 421 11 13 1 2 117 58 0
447 274 20 56 1 2 117 58 0
442 304 35 41 1 2 117 58 0
199 254 173 19 1 2 117 58 0
369 258 34 16 1 2 117 58 0
199 250 80 15 1 2 117 58 0
685 200 50 10 1 2 117 58 0
762 218 34 7 1 2 117 58 0
697 504 35 55 1 2 117 58 0
320 687 20 41 1 2 117 58 0
318 723 17 16 1 2 117 58 0
319 737 14 12 1 2 117 58 0
319 749 11 13 1 2 117 58 0
337 687 6 30 1 2 117 58 0
326 749 13 32 1 2 117 58 0
337 755 28 22 1 2 117 58 0
363 759 32 17 1 2 117 58 0
339 688 28 8 1 2 117 58 0
485 678 49 10 1 2 117 58 0
108 415 23 58 1 2 117 58 0
110 466 15 18 1 2 117 58 0
-9 85 393 7 1 0 51 102 0
407 86 402 6 1 0 51 102 0
-8 -10 819 96 0 0 7 172 214
384 84 24 8 0 0 7 172 214
154 13 51 18 3 0 255 255 255
174 9 18 13 3 0 255 255 255
159 10 21 13 3 0 255 255 255
190 12 13 12 3 0 255 255 255
159 22 21 13 3 0 255 255 255
176 26 20 11 3 0 255 255 255
194 22 12 10 3 0 255 255 255
153 22 16 8 3 0 255 255 255
152 15 20 10 3 0 255 255 255
199 15 9 12 3 0 255 255 255
506 28 48 20 3 0 255 255 255
510 26 22 10 3 0 255 255 255
527 24 20 17 3 0 255 255 255
502 36 18 10 3 0 255 255 255
504 30 17 13 3 0 255 255 255
544 27 17 15 3 0 255 255 255
538 37 21 14 3 0 255 255 255
525 41 20 13 3 0 255 255 255
513 40 16 14 3 0 255 255 255
506 41 14 10 3 0 255 255 255
731 5 33 31 3 0 255 255 0
0

//file format:

mapWidth mapHeight
spawnPointX spawnPointY
numberOfRectanglesToReadFromTheFile
topLeftCornerX topLeftCornerY width height collision climbable r g b //each of these lines represents one rectangle
warpCount
warpToMapNum warpToXCoord warpToYCoord

//collision can be: 0 (no collision, draw behind char), 1 (collision), 2 (no collision, draw in front of char), 3 (no collision oval, draw behind char), 4 (no collision oval, draw in front of char), or 5 (warp. is not drawn, but will teleport the player).
//climbable can be: 0 (can't climb), 1 (can climb, no gravity applies), or 2 (can climb, slow gravity applies). anything greater than or eqaul to 10 is to keep track of which warp is assigned to which warp recangle (10 = warp 0, 11 = warp 1, etc.).

